##########
#S       #
#  ##### #
#  #   # #
#  # # # #
#    #   #
######   #
#        #
#       E#
##########
